HHHHHHHHHHHHHHH
H..........HHHH
H......HH..HHHH
H......HH..HHHH
HHHHH.........H
HHHHH.........H
HHHHHHH..HHHH.H
HHHHHHH..HHHH.H
H........HHHH.H
H.............H
H...HHHHH.....H
HHHHHHHHHHHMHHH