###############
########g(10)######
########mg(12)#####
#####h(53)#########
##########h(34)####
###############
###############
###############
###############
###^####h(17)######
###############
###############