HHHHHHHHHHHHHHH
HGGGGGGH......H
HGGGGGGH......H
HGGGGGGHHHHH..H
HGGGGGG.......H
HGGGGGG.......H
HHHHH.........H
HGGGH.........H
HGGGH.........H
HGG...........H
Hg............H
HHHHHHHHHHHHHHH
