HHHHHHHHHHHHHHHHHHHH
H..................H
H..................H
H.....HH....HH.....H
H....H..GZZG..H....H
H....H..GZZG..H....H
H....H..GZZG..H....H
H...HZGGGHHGGGZH...H
H...HZG[GH][GH]HH[GH][GH]GZH...H
H...HZGGGZZGGGZH...H
H...HZGGGZZGGGZH...H
H....H..GZZG..H....H
H....H..GHHG..H....H
H....H...HH...H....H
H..................H
H..................H
H..................H
HHHHHHHHHHHHHHHHHHHH
