HHHHHHHHHHHHHHH
H.............H
H.....GZG.....H
H...HGGZGGH...H
H...HGGZGGH...H
H..HGGGZGGGH..H
H..HGGGZGGGH..H
H...HGGZGGH...H
H...HGGZGGH...H
H.....GZG.....H
H.............H
HHHHHHHHHHHHHHH
