HHHHHHHHHHHHHHH
HHHMMMHHHMMMHHH
HHHMHHHHHMHMHHH
HHHMMHHHHMMHHHH
HHHMHHHHHMHMHHH
HHHMHHHHHMHMHHH
HHHHHHHHHHHHHHH
.......^.......
HHHHHHHHHHHHHHH
HHHHHHHHHHHHHHH
HHHHHHHHHHHHHHH
HHHHHHHHHHHHHHH
