[{r1}{r2}{r3}{r4}]

{r1}
...............
...............
...............
...............
......G........
......H........
....RHHHG......
......H........
......G........
...............
...............
...............

{r2}
...............
...............
...............
......G........
......H........
.....HHH.......
...RHHHHHG.....
.....HHH.......
......H........
......G........
...............
...............

{r3}
...............
...............
......G........
......H........
.....HHH.......
....HHHHH......
..RHHHHHHHG....
....HHHHH......
.....HHH.......
......H........
......G........
...............

{r4}
...............
......G........
......H........
.....HHH.......
....HHHHH......
...HHHHHHH.....
.RHHHHHHHHHG...
...HHHHHHH.....
....HHHHH......
.....HHH.......
......H........
......G........
