HHHHHHHHHHHHHHHHHHHH
HGGGGGGGGHGGG......H
HGGGGGGGGHGGG......H
HGGGGGGGGHGGG......H
HGGGGGGGGHHHHHH....H
HGGGGGGG...........H
HGGGGGGG...........H
HHHHHHH............H
HGGGGGH............H
HGGGGGH............H
HGGGGGH......HH....H
HGGGGGH.....HHH....H
HGGG.......HH......H
HGG.......HHHHH....H
HG.........HHHH....H
HHHH........HH.....H
HHHHH..............H
HHHHHHHHHHHHHHHHHHHH
