hhhhhhhhhhhhhhh
hOOOOOOOOOOOOOh
hOOOOOmOOOmOOOh
hOOOOOOOOOOOOOh
hOOOOO^OOOOOOOh
hOOOOOOOOOOOOOh
hOOOOOOOOOOOOOh
hOOOOOgOOOmOOOh
hOOOOOOOOOOOOOh
hOOOOOOOOOOOOOh
hOOOOOOOOOOOOOh
hhhhhhhhhhhhhhh