hhhhhhhhhhhhhhh
h.............h
h.....m...m...h
h.............h
h.....^.......h
h.............h
h.............h
h.....g...m...h
h.............h
h.............h
h.............h
hhhhhhhhhhhhhhh